R 1520 1250

NO ./textures/north_wall.xpm
SO ./textures/south_wall.xpm
WE ./textures/west_wall.xpm
E ./textures/east_wall.xpm
S ./textures/sprite.xpm


F 100,100,100
C 225,225,255

1 1 1 1 1 1 1 1 1 1
1 0 0 0 0 0 1 0 1 1
1 0 0 0 0 0 1 0 1 1
1 1 1 0 0 0 0 0 0 1
1 0 0 1 1 0 0 2 0 1
1 0 0 0 0 0 0 0 0 1
1 0 0 1 1 0 1 1 S 1
1 0 0 0 1 1 1 1 0 1
1 0 0 2 0 0 0 0 0 1
1 1 0 0 0 1 0 1 0 1
1 1 1 1 1 1 1 1 1 1